0B0__0__00
____0__0__
__0____0__
___0000___
__________
A__0000___
__0____0__
_0__0__0__
0__0__0__0
0________0